0 0 0 0 0 0 0 0 0 0 0 0 0 0 0 0 0 0 0 0 0 0 0 0 0 0 0 0 0 0
0 0 0 0 0 0 0 0 0 0 222 222 333 333 0 333 333 333 333 333 222 222 0 0 0 0 0 0 0 0
0 0 0 0 0 0 0 0 0 0 222 222 222 222 0 222 222 222 222 222 222 222 0 0 0 0 0 0 0 0
0 0 0 0 444 444 444 0 0 0 0 0 0 0 0 0 0 0 667 667 0 0 0 0 0 556 0 0 0 0
0 0 0 444 556 556 556 444 0 0 0 0 0 0 0 0 0 667 667 667 667 0 0 0 556 556 556 0 0 0
0 0 0 444 556 556 556 444 0 0 222 222 0 0 0 0 0 667 667 667 667 0 0 556 556 556 556 556 0 0
0 0 0 444 556 556 556 444 0 0 222 222 0 0 0 0 0 667 667 667 667 0 0 0 556 556 556 0 0 0
0 0 0 0 444 444 444 0 0 0 0 0 0 0 0 0 0 0 0 0 0 0 0 0 0 0 0 0 0 0
0 0 0 0 0 0 0 0 0 0 0 0 0 0 0 0 0 0 0 0 0 0 0 0 0 0 0 0 0 0
0 0 0 0 0 0 0 0 0 0 0 0 0 0 0 0 0 0 0 0 0 0 0 0 0 0 0 0 0 0
0 0 0 0 444 444 444 444 0 0 0 0 0 0 0 0 0 0 0 0 0 0 0 0 0 0 0 0 0 0
0 0 0 444 444 444 444 444 444 0 0 0 0 0 0 0 0 0 0 0 0 0 0 0 0 0 0 0 0 0
0 0 444 444 556 556 444 444 444 444 0 0 0 0 0 0 0 0 0 0 0 0 0 0 0 0 0 0 0 0
0 0 444 556 556 556 556 444 444 444 0 0 0 0 0 0 0 0 0 0 0 0 0 0 0 0 0 0 0 0
0 0 444 556 556 556 556 444 444 444 0 0 0 0 0 0 0 0 0 0 0 0 0 0 0 0 0 0 0 0
0 0 444 556 556 556 556 444 444 444 0 0 0 0 0 0 0 0 0 0 0 0 0 0 0 0 0 0 0 0
0 0 444 556 556 556 556 444 444 444 0 0 0 0 0 0 667 778 778 889 889 889 889 889 889 889 889 778 778 0
0 0 444 444 556 556 444 444 444 444 0 0 0 0 0 0 778 778 889 889 1000 1000 1000 1000 1000 1000 889 889 778 0
0 0 0 444 444 444 444 444 444 0 0 0 0 0 0 0 778 889 1000 1000 1000 1000 1000 1000 1000 1000 1000 1000 889 0
0 0 0 0 444 444 444 444 0 0 0 0 0 0 0 0 778 889 1000 1000 1000 1000 1000 1000 1000 1000 1000 1000 889 0
0 0 0 0 0 0 0 0 0 0 0 0 0 0 0 0 889 889 1000 1000 1000 1000 1000 1000 1000 1000 1000 1000 889 0
0 0 0 0 0 0 333 333 333 333 0 0 0 0 0 0 889 889 1000 1000 1000 1000 1000 1000 1000 1000 1000 1000 889 0
0 0 0 0 333 333 333 333 333 333 333 333 0 0 0 0 778 889 1000 1000 1000 1000 1000 1000 1000 1000 1000 1000 889 0
0 0 0 0 333 333 333 333 333 333 333 333 0 0 0 0 778 889 1000 1000 1000 1000 1000 1000 1000 1000 1000 1000 889 0
0 0 0 0 333 333 333 333 333 333 333 333 0 0 0 0 778 778 889 889 1000 1000 1000 1000 1000 1000 889 889 778 0
0 0 0 0 333 333 333 333 333 333 333 333 0 0 0 0 667 778 778 889 889 889 889 889 889 889 889 778 778 0
0 0 0 0 333 333 333 333 333 333 333 333 0 0 0 0 0 667 778 778 778 778 778 778 778 778 778 778 667 0
0 0 0 0 0 0 333 333 333 333 0 0 0 0 0 0 0 0 0 667 667 778 778 778 778 667 667 0 0 0
0 0 0 0 0 0 0 0 0 0 0 0 0 0 0 0 0 0 0 0 0 0 0 0 0 0 0 0 0 0
0 0 0 0 0 0 0 0 0 0 0 0 0 0 0 0 0 0 0 0 0 0 0 0 0 0 0 0 0 0
